Precinct,Krasner,Khan,Untermeyer,El Shabazz,Negrin,Deni,O'Neill,Write In,Total
01-01,73,24,2,1,15,0,17,0,132
01-02,103,30,8,0,12,0,14,0,167
01-03,116,21,3,0,26,3,26,0,195
01-04,75,23,5,4,15,4,6,0,132
01-05,33,10,1,1,8,1,4,0,58
01-06,50,16,5,1,9,0,7,0,88
01-07,39,8,8,7,4,0,3,0,69
01-08,73,20,7,0,8,2,7,0,117
01-09,83,16,6,0,10,1,22,0,138
01-10,115,20,6,0,7,1,6,0,155
01-11,127,51,2,0,29,3,16,0,228
01-12,57,6,5,4,8,0,3,0,83
01-13,76,21,5,2,10,2,8,0,124
01-14,80,13,7,4,8,3,5,0,120
01-15,120,28,12,5,29,5,9,0,208
01-16,57,18,5,0,5,1,16,0,102
01-17,50,17,11,4,18,3,16,0,119
01-18,39,19,4,2,26,0,68,0,158
01-19,44,31,11,0,22,1,57,0,166
01-20,102,40,6,3,33,4,24,0,212
01-21,46,20,10,1,15,0,35,0,127
02-01,90,54,9,3,34,0,14,0,204
02-02,70,18,7,9,12,3,3,0,122
02-03,76,28,5,1,8,2,6,0,126
02-04,96,30,4,0,19,3,6,0,158
02-05,102,20,7,3,23,1,2,0,158
02-06,120,31,6,3,14,4,17,0,195
02-07,117,40,8,7,21,1,9,0,203
02-08,69,31,4,6,13,3,3,0,129
02-09,77,31,12,15,13,3,3,0,154
02-10,108,38,3,2,22,0,2,0,175
02-11,105,38,7,4,23,1,4,0,182
02-12,112,34,5,5,15,3,3,0,177
02-13,10,3,1,1,2,0,1,0,18
02-14,70,38,15,7,15,2,5,0,152
02-15,78,64,10,5,40,1,6,0,204
02-16,181,92,8,5,22,3,6,0,317
02-17,116,28,4,1,18,1,3,0,171
02-18,110,32,3,1,12,2,4,1,165
02-19,123,22,2,9,13,5,1,0,175
02-20,35,33,2,3,9,0,1,0,83
02-21,54,39,3,9,15,0,0,0,120
02-22,113,79,3,2,25,2,3,0,227
02-23,113,76,6,3,18,6,8,0,230
02-24,123,49,9,3,21,2,4,0,211
02-25,120,47,10,2,20,1,2,0,202
02-26,131,79,19,0,30,4,4,0,267
02-27,101,96,12,4,38,1,6,0,258
03-01,18,17,8,14,10,0,0,0,67
03-02,22,11,13,22,10,1,2,0,81
03-03,35,16,26,23,12,0,2,0,114
03-04,22,13,43,17,12,1,0,0,108
03-05,17,10,20,15,12,0,2,0,76
03-06,27,21,13,17,9,2,6,0,95
03-07,19,11,30,19,9,1,3,0,92
03-08,29,10,30,26,14,1,1,0,111
03-09,33,17,35,23,19,1,2,0,130
03-10,35,14,23,26,5,1,1,0,105
03-11,58,23,27,22,16,2,4,0,152
03-12,29,14,20,26,4,3,3,0,99
03-13,14,7,23,18,3,3,1,0,69
03-14,47,18,25,25,7,2,1,0,125
03-15,39,23,25,22,13,5,0,0,127
03-16,40,14,30,29,14,0,1,0,128
03-17,55,16,37,20,12,0,4,0,144
03-18,28,17,36,27,7,0,4,0,119
03-19,52,16,7,52,2,2,7,0,138
03-20,39,10,9,26,9,0,0,0,93
03-21,13,9,7,8,4,1,2,0,44
03-22,35,11,13,12,7,0,0,0,78
04-01,28,14,10,27,10,8,3,0,100
04-02,22,27,9,40,13,1,1,0,113
04-03,24,13,16,50,11,1,3,0,118
04-04,21,6,5,19,6,0,0,0,57
04-05,51,7,13,30,6,1,1,0,109
04-06,28,10,4,27,7,1,3,0,80
04-07,34,22,16,29,14,1,2,0,118
04-08,26,34,11,31,9,2,1,0,114
04-09,33,18,17,34,14,1,1,0,118
04-10,32,20,8,26,14,1,1,0,102
04-11,33,11,11,33,7,4,5,0,104
04-12,21,10,10,29,5,1,0,0,76
04-13,36,23,14,22,21,1,2,0,119
04-14,25,7,10,29,4,2,1,0,78
04-15,25,9,5,36,10,0,0,0,85
04-16,38,14,7,21,6,1,1,1,89
04-17,33,24,8,37,6,1,1,0,110
04-18,28,17,9,38,10,3,0,0,105
04-19,21,14,4,14,5,1,2,0,61
04-20,25,9,11,28,12,0,4,0,89
04-21,53,27,7,41,17,0,4,0,149
05-01,100,112,15,3,64,4,8,0,306
05-02,44,63,17,2,40,0,6,0,172
05-03,75,80,12,2,47,1,1,0,218
05-04,130,86,13,0,49,2,6,0,286
05-05,132,69,18,3,22,3,4,0,251
05-06,137,64,4,0,46,2,4,1,258
05-07,105,43,8,1,24,1,1,0,183
05-08,130,71,20,7,28,3,8,0,267
05-09,96,47,6,10,29,3,6,0,197
05-10,25,32,14,0,23,3,3,0,100
05-11,95,60,13,5,23,1,4,0,201
05-12,110,88,10,2,35,4,4,0,253
05-13,14,8,0,2,2,0,1,0,27
05-14,109,40,1,4,17,1,3,0,175
05-15,85,32,8,0,13,3,2,0,143
05-16,82,52,7,4,22,5,0,0,172
05-17,160,101,7,4,35,5,1,0,313
05-18,78,137,29,1,55,2,2,0,304
05-19,97,99,22,4,76,2,6,0,306
05-20,67,23,4,2,9,0,4,0,109
05-21,165,90,8,5,25,5,6,0,304
05-22,62,62,7,2,17,2,2,0,154
05-23,138,54,11,14,20,3,1,0,241
05-24,79,57,3,0,32,3,2,0,176
05-25,82,41,3,3,16,0,1,0,146
05-26,91,75,7,3,38,1,3,0,218
05-27,93,63,14,5,31,4,4,0,214
05-28,54,30,7,3,12,0,3,0,109
05-29,25,10,1,0,5,0,0,0,41
06-01,95,14,9,16,13,2,2,0,151
06-02,38,19,14,11,17,0,0,0,99
06-03,72,12,3,24,7,0,1,0,119
06-04,43,17,7,20,19,0,1,0,107
06-05,25,13,5,9,3,1,1,0,57
06-06,57,17,7,12,11,1,0,0,105
06-07,25,16,7,28,19,2,2,0,99
06-08,28,7,1,13,4,1,0,0,54
06-09,27,5,3,8,9,3,4,0,59
06-10,15,8,5,19,5,1,0,0,53
06-11,46,21,11,13,11,2,3,0,107
06-12,33,8,3,11,8,1,1,0,65
06-13,35,7,1,14,5,1,1,0,64
06-14,23,10,1,14,10,0,0,0,58
06-15,35,10,4,20,4,0,0,0,73
06-16,37,2,3,22,7,1,0,0,72
06-17,53,11,6,19,3,2,0,0,94
06-18,66,24,14,17,10,0,10,0,141
07-01,5,6,5,0,12,0,1,0,29
07-02,0,1,0,1,13,0,1,0,16
07-03,0,0,2,0,5,0,0,0,7
07-04,4,3,1,0,36,0,1,0,45
07-05,1,8,5,3,21,1,0,0,39
07-06,8,3,4,2,12,0,1,0,30
07-07,1,3,1,1,17,0,0,0,23
07-08,7,8,7,5,11,1,0,0,39
07-09,7,5,3,0,5,1,0,0,21
07-10,1,4,0,1,14,0,0,0,20
07-11,1,3,1,0,16,0,0,0,21
07-12,6,2,0,1,13,1,0,0,23
07-13,0,1,0,1,2,0,0,0,4
07-14,1,7,7,1,2,1,1,1,21
07-15,1,6,0,0,13,1,0,0,21
07-16,4,1,2,0,8,1,0,0,16
07-17,3,2,1,0,47,0,0,0,53
07-18,2,3,1,3,8,1,0,0,18
07-19,1,2,1,1,4,0,0,0,9
07-20,1,4,2,0,7,2,0,0,16
07-21,11,4,1,2,14,0,1,0,33
07-22,7,2,1,0,10,0,0,0,20
07-23,8,2,1,2,5,0,0,0,18
08-01,92,86,3,0,24,2,4,0,211
08-02,85,75,5,1,44,0,2,0,212
08-03,119,69,5,0,40,3,5,0,241
08-04,104,56,6,0,34,1,2,0,203
08-05,83,59,7,2,27,2,2,0,182
08-06,59,83,7,1,47,1,2,0,200
08-07,84,70,17,7,37,4,3,0,222
08-08,112,54,6,2,34,6,2,0,216
08-09,112,74,8,1,23,0,4,0,222
08-10,68,87,14,2,69,4,0,0,244
08-11,45,41,8,1,17,1,4,0,117
08-12,77,56,10,1,24,0,5,0,173
08-13,88,23,3,2,12,2,1,0,131
08-14,109,83,8,4,33,2,3,0,242
08-15,68,48,11,4,29,2,7,0,169
08-16,122,65,21,1,52,1,8,0,270
08-17,52,38,9,3,17,1,2,0,122
08-18,113,70,15,5,47,1,9,0,260
08-19,70,93,10,2,39,2,1,0,217
08-20,22,21,8,2,18,3,3,0,77
08-21,83,74,13,4,41,4,9,0,228
08-22,19,19,0,3,8,8,0,0,57
08-23,90,60,11,4,37,2,6,0,210
08-24,107,89,19,6,54,4,10,0,289
08-25,71,51,25,4,16,5,0,0,172
08-26,121,55,9,9,28,3,5,0,230
08-27,63,21,4,4,18,1,1,0,112
08-28,111,75,6,0,55,4,2,0,253
08-29,99,116,39,2,68,2,14,0,340
08-30,50,50,6,4,26,0,2,0,138
09-01,111,86,7,22,15,3,3,0,247
09-02,90,124,5,15,32,0,6,0,272
09-03,198,91,4,21,18,1,3,0,336
09-04,66,83,4,4,34,0,20,0,211
09-05,74,94,10,3,28,1,23,0,233
09-06,93,68,3,0,49,3,18,0,234
09-07,40,103,8,2,34,1,9,0,197
09-08,35,56,5,1,25,1,15,0,138
09-09,101,141,7,0,54,1,15,0,319
09-10,95,90,9,1,48,1,24,0,268
09-11,118,118,6,4,61,2,22,0,331
09-12,152,107,9,9,26,0,3,0,306
09-13,166,127,2,2,8,0,2,0,307
09-14,128,69,3,1,19,1,0,0,221
09-15,156,105,4,6,36,2,5,0,314
09-16,53,53,10,7,10,1,0,0,134
09-17,42,47,15,18,16,4,2,0,144
10-01,65,20,11,17,5,2,1,0,121
10-02,94,18,7,19,10,1,0,0,149
10-03,62,11,9,23,11,1,2,0,119
10-04,60,15,7,27,11,0,0,0,120
10-05,79,30,13,28,12,1,0,0,163
10-06,81,19,2,25,7,2,3,0,139
10-07,61,22,11,16,16,1,1,0,128
10-08,57,10,4,19,13,0,0,0,103
10-09,62,13,15,33,6,1,1,0,131
10-10,43,21,6,25,6,0,0,0,101
10-11,39,12,10,15,4,0,1,0,81
10-12,65,16,8,27,8,1,3,0,128
10-13,80,17,11,37,5,1,1,0,152
10-14,75,45,14,23,9,1,0,0,167
10-15,73,16,3,23,11,1,0,0,127
10-16,50,14,3,23,7,0,1,0,98
10-17,56,16,3,24,10,1,5,0,115
10-18,65,14,7,21,9,0,1,0,117
10-19,56,18,4,31,12,2,1,0,124
10-20,77,21,4,23,9,2,0,0,136
10-21,50,29,10,36,14,1,2,0,142
10-22,50,19,8,27,6,1,0,0,111
10-23,57,26,10,25,14,1,3,0,136
10-24,68,15,7,23,6,1,4,0,124
10-25,64,17,8,25,6,0,3,0,123
10-26,70,13,7,28,6,0,0,0,124
10-27,41,28,7,29,5,1,0,0,111
10-28,71,22,4,30,10,1,1,0,139
10-29,101,25,10,35,5,0,0,0,176
11-01,9,7,4,12,2,1,1,0,36
11-02,45,8,2,24,6,1,1,0,87
11-03,21,4,3,41,2,2,1,0,74
11-04,8,4,2,10,7,0,0,0,31
11-05,10,13,4,8,6,1,0,0,42
11-06,20,11,6,15,5,0,0,0,57
11-07,21,17,4,17,11,0,1,0,71
11-08,32,10,8,32,11,0,0,0,93
11-09,23,23,12,23,20,1,1,0,103
11-10,19,8,1,14,4,2,0,0,48
11-11,11,15,10,38,5,2,6,0,87
11-12,12,5,7,11,16,0,0,0,51
11-13,16,13,7,36,7,1,0,0,80
11-14,26,14,6,16,6,0,1,0,69
11-15,6,5,11,9,3,0,0,0,34
11-16,22,16,17,23,18,2,2,0,100
11-17,15,4,12,17,7,0,0,0,55
11-18,12,9,12,23,12,1,0,0,69
11-19,20,5,9,44,8,0,0,0,86
11-20,52,10,7,24,7,1,3,0,104
12-01,45,15,11,37,8,1,0,0,117
12-02,22,13,9,36,13,1,0,0,94
12-03,14,14,10,17,5,0,0,0,60
12-04,16,5,4,25,3,0,0,0,53
12-05,33,26,12,50,20,1,2,0,144
12-06,32,10,8,26,6,2,1,0,85
12-07,44,25,13,27,9,2,0,0,120
12-08,49,18,7,31,6,3,2,0,116
12-09,53,16,7,14,7,0,1,0,98
12-10,36,11,6,24,8,0,1,0,86
12-11,72,26,7,45,10,2,0,0,162
12-12,37,19,7,35,3,5,1,0,107
12-13,21,11,5,29,3,1,0,0,70
12-14,29,11,16,18,8,2,0,0,84
12-15,77,20,9,34,8,0,2,0,150
12-16,85,28,4,19,18,3,2,0,159
12-17,49,23,9,27,4,0,1,0,113
12-18,22,20,5,27,5,0,0,0,79
12-19,25,16,6,18,4,1,1,0,71
12-20,45,13,6,25,8,1,1,0,99
12-21,32,10,9,23,9,2,1,0,86
12-22,92,46,10,15,12,1,0,0,176
12-23,142,28,5,21,9,1,1,0,207
12-24,31,22,5,17,4,0,1,0,80
13-01,41,20,14,33,6,0,5,0,119
13-02,42,18,8,30,6,0,0,0,104
13-03,32,14,4,31,12,1,1,0,95
13-04,101,33,2,25,11,0,2,0,174
13-05,65,29,6,23,12,1,3,0,139
13-06,21,26,10,29,15,1,10,0,112
13-07,15,13,4,12,9,0,4,0,57
13-08,12,16,7,13,9,0,7,0,64
13-09,22,20,12,14,10,0,7,0,85
13-10,16,28,12,23,9,0,6,0,94
13-11,11,4,9,13,6,2,6,0,51
13-12,14,9,3,27,5,0,3,0,61
13-13,28,20,7,13,6,1,6,0,81
13-14,30,21,11,18,18,2,20,0,120
13-15,22,11,6,12,6,1,6,0,64
13-16,0,0,0,0,0,0,0,0,0
13-17,12,4,2,6,2,1,2,0,29
13-18,19,20,14,29,28,1,18,0,129
13-19,20,21,17,29,8,1,7,0,103
13-20,21,11,11,16,12,2,3,0,76
13-21,21,19,5,15,11,0,3,0,74
13-22,46,22,14,22,6,0,4,0,114
13-23,22,20,12,20,9,2,0,0,85
13-24,13,16,11,14,10,1,2,0,67
13-25,14,14,2,26,6,2,0,0,64
14-01,94,35,3,15,18,8,2,0,175
14-02,24,16,12,17,16,10,0,0,95
14-03,47,22,8,12,7,6,1,0,103
14-04,53,21,19,20,19,4,2,0,138
14-05,25,17,8,10,4,4,0,0,68
14-06,13,6,4,29,3,2,1,0,58
14-07,26,8,5,5,12,2,0,0,58
14-08,2,0,2,5,2,0,0,0,11
14-09,16,9,10,6,13,1,1,0,56
14-10,45,17,18,17,17,7,3,0,124
14-11,44,11,10,11,8,5,3,0,92
15-01,103,58,8,2,48,3,8,0,230
15-02,104,73,6,3,46,4,5,0,241
15-03,117,41,11,5,28,2,6,0,210
15-04,47,42,6,2,11,9,2,0,119
15-05,64,63,7,1,49,4,3,0,191
15-06,121,131,45,1,72,6,9,0,385
15-07,88,23,5,13,18,2,1,0,150
15-08,87,43,4,2,22,1,8,0,167
15-09,83,57,10,1,41,1,5,0,198
15-10,0,0,0,0,0,0,0,0,0
15-11,48,33,6,10,26,1,3,0,127
15-12,78,53,10,3,36,5,6,0,191
15-13,57,58,7,2,35,2,5,0,166
15-14,90,69,7,0,29,4,7,0,206
15-15,72,27,5,4,17,3,3,0,131
15-16,109,53,5,2,30,3,3,0,205
15-17,76,58,7,1,39,3,2,0,186
15-18,96,53,10,0,38,1,4,0,202
15-19,57,86,12,0,26,4,3,0,188
16-01,17,8,11,11,5,0,0,0,52
16-02,17,11,20,7,6,1,1,0,63
16-03,12,3,11,11,4,0,1,0,42
16-04,6,8,25,6,3,1,2,0,51
16-05,5,9,15,10,3,0,0,0,42
16-06,14,8,5,9,7,0,1,0,44
16-07,15,8,13,18,7,1,7,0,69
16-08,17,10,20,19,5,0,2,0,73
16-09,22,7,10,18,7,0,1,0,65
16-10,8,4,10,11,4,0,1,0,38
16-11,14,8,5,4,2,0,1,0,34
16-12,6,4,5,10,3,1,5,0,34
16-13,12,9,10,14,5,0,7,0,57
16-14,10,1,0,4,7,0,0,0,22
16-15,5,3,5,11,9,0,1,0,34
16-16,7,6,0,5,11,1,5,0,35
16-17,30,14,11,28,7,0,10,0,100
16-18,31,18,24,13,13,1,1,0,101
17-01,42,15,14,23,4,0,1,0,99
17-02,42,19,20,21,3,1,2,0,108
17-03,33,26,7,33,5,1,0,0,105
17-04,34,27,13,35,26,0,2,0,137
17-05,26,32,9,26,5,1,0,0,99
17-06,30,31,3,50,5,0,0,1,120
17-07,43,22,6,35,4,2,0,0,112
17-08,32,39,11,24,8,0,1,0,115
17-09,34,17,5,33,6,0,1,0,96
17-10,22,18,6,52,4,0,0,0,102
17-11,45,13,4,23,8,0,1,0,94
17-12,48,14,8,43,8,1,0,0,122
17-13,44,20,6,29,14,1,0,0,114
17-14,67,16,5,32,8,0,0,0,128
17-15,24,15,3,65,4,0,0,0,111
17-16,23,12,7,20,4,1,0,0,67
17-17,27,23,3,31,4,1,0,0,89
17-18,34,10,8,38,6,0,2,0,98
17-19,57,18,9,16,10,0,1,0,111
17-20,49,30,10,33,7,3,2,0,134
17-21,38,26,9,27,4,0,1,0,105
17-22,33,21,5,22,6,0,2,0,89
17-23,15,7,4,12,7,0,1,0,46
17-24,37,15,10,34,12,0,0,0,108
17-25,33,7,5,18,5,1,1,0,70
17-26,13,9,3,6,0,0,0,0,31
17-27,23,14,9,24,11,0,2,0,83
17-28,16,13,5,49,9,1,0,0,93
17-29,34,10,12,34,4,3,0,0,97
18-01,156,33,12,3,27,2,8,0,241
18-02,125,50,13,2,27,3,10,0,230
18-03,12,2,23,2,5,0,0,0,44
18-04,87,35,14,3,19,2,5,0,165
18-05,80,29,6,1,10,2,6,0,134
18-06,95,33,5,1,7,1,4,0,146
18-07,105,41,10,0,11,3,8,0,178
18-08,10,7,1,2,1,0,1,0,22
18-09,109,31,6,3,16,5,2,0,172
18-10,92,34,15,3,17,2,9,0,172
18-11,106,28,6,2,13,4,17,0,176
18-12,119,31,9,0,19,1,10,0,189
18-13,13,7,9,1,11,1,0,0,42
18-14,60,13,4,2,6,1,3,0,89
18-15,41,6,15,3,18,0,1,0,84
18-16,58,15,9,3,6,3,1,0,95
18-17,97,17,10,3,19,0,3,0,149
19-01,7,3,0,1,22,0,0,0,33
19-02,4,6,4,1,11,1,0,0,27
19-03,1,1,1,2,9,0,0,0,14
19-04,4,1,0,0,10,0,0,0,15
19-05,2,2,0,0,12,0,0,0,16
19-06,0,0,0,0,0,0,0,0,0
19-07,0,0,0,0,0,0,0,0,0
19-08,1,3,4,1,18,0,1,0,28
19-09,4,10,3,1,10,0,4,0,32
19-10,14,4,2,3,26,1,0,0,50
19-11,12,3,1,3,11,0,0,0,30
19-12,21,2,3,2,27,1,0,0,56
19-13,18,9,5,4,14,0,1,0,51
19-14,6,3,0,2,5,0,0,0,16
19-15,5,2,1,3,27,0,0,0,38
19-16,3,4,4,0,29,0,0,0,40
19-17,6,4,0,5,14,1,0,0,30
19-18,16,2,5,3,19,0,0,0,45
19-19,2,2,2,0,11,0,0,0,17
20-01,27,10,6,7,5,2,0,0,57
20-02,17,6,4,3,2,1,1,0,34
20-03,42,13,15,16,34,0,0,0,120
20-04,22,15,8,14,21,1,0,0,81
20-05,3,7,4,2,6,0,0,0,22
20-06,60,32,23,23,41,2,1,0,182
20-07,29,8,10,15,14,3,0,0,79
20-08,18,1,0,1,4,0,0,0,24
20-09,9,8,4,7,5,1,1,0,35
20-10,20,4,9,9,10,1,0,0,53
20-11,15,2,0,1,3,1,0,0,22
21-01,51,37,0,1,19,2,6,0,116
21-02,38,41,4,1,12,0,9,0,105
21-03,31,34,7,14,15,1,4,0,106
21-04,19,21,2,0,9,1,3,0,55
21-05,54,52,12,5,30,2,7,0,162
21-06,40,17,0,1,11,2,4,0,75
21-07,29,21,0,1,4,2,4,0,61
21-08,24,23,0,0,6,1,1,0,55
21-09,30,47,2,1,7,3,12,0,102
21-10,31,21,5,2,8,2,3,0,72
21-11,46,24,6,5,21,0,5,0,107
21-12,34,39,4,1,7,0,6,0,91
21-13,27,41,1,1,7,2,12,0,91
21-14,60,62,1,13,28,3,8,0,175
21-15,48,47,2,1,17,1,13,0,129
21-16,19,19,6,0,9,3,8,0,64
21-17,33,54,8,3,19,1,8,0,126
21-18,38,41,4,1,14,3,4,0,105
21-19,23,36,1,2,7,0,14,0,83
21-20,32,51,0,0,12,0,5,0,100
21-21,33,27,2,0,9,2,10,0,83
21-22,46,62,9,10,15,3,10,0,155
21-23,80,40,10,11,32,2,6,0,181
21-24,167,114,12,6,37,3,3,0,342
21-25,46,34,5,1,20,2,9,0,117
21-26,26,41,4,1,14,5,14,0,105
21-27,29,36,5,3,19,3,6,0,101
21-28,37,45,8,3,24,1,18,0,136
21-29,35,40,6,5,20,3,12,0,121
21-30,55,38,6,7,31,2,6,0,145
21-31,20,35,7,1,25,2,22,0,112
21-32,14,28,5,4,24,0,9,0,84
21-33,60,53,15,9,56,4,16,0,213
21-34,52,72,13,6,64,3,25,0,235
21-35,43,47,3,2,15,3,20,0,133
21-36,22,16,3,4,10,1,6,0,62
21-37,30,26,1,2,19,2,6,0,86
21-38,19,25,7,2,25,1,29,0,108
21-39,44,51,6,8,23,4,14,0,150
21-40,30,44,12,6,23,6,5,0,126
21-41,29,45,11,6,24,2,11,0,128
21-42,14,31,6,3,16,2,9,0,81
21-43,15,27,6,3,16,0,14,0,81
21-44,22,26,7,0,30,1,11,0,97
21-45,49,73,4,0,43,2,2,0,173
22-01,260,96,5,5,30,2,1,0,399
22-02,193,112,1,13,54,0,0,0,373
22-03,76,62,8,16,17,2,2,0,183
22-04,127,54,2,16,15,2,1,0,217
22-05,147,51,5,17,29,2,4,0,255
22-06,158,70,10,15,17,2,4,0,276
22-07,144,49,7,13,26,1,1,0,241
22-08,86,51,9,27,17,4,1,0,195
22-09,81,28,4,18,5,0,0,0,136
22-10,100,51,11,31,15,1,1,0,210
22-11,48,25,4,23,9,0,2,0,111
22-12,34,29,7,21,16,0,0,0,107
22-13,88,11,4,18,12,0,0,0,133
22-14,53,40,7,34,15,2,1,0,152
22-15,41,24,12,44,12,1,1,0,135
22-16,77,39,3,20,8,0,1,0,148
22-17,104,63,5,25,10,1,3,0,211
22-18,85,42,10,27,11,1,4,0,180
22-19,74,29,11,15,7,1,1,0,138
22-20,55,25,5,18,13,2,1,0,119
22-21,49,45,8,23,7,4,2,0,138
22-22,39,33,3,37,7,0,2,0,121
22-23,129,51,9,14,19,1,2,0,225
22-24,105,67,9,20,39,0,1,0,241
22-25,58,26,6,27,13,0,3,0,133
22-26,52,38,2,27,14,2,2,0,137
22-27,81,47,9,49,12,0,1,0,199
22-28,67,39,4,24,13,0,2,0,149
22-29,58,51,10,45,13,4,2,0,183
23-01,1,5,2,3,2,0,7,0,20
23-02,9,4,6,5,5,0,6,0,35
23-03,7,3,4,1,3,0,5,0,23
23-04,10,27,6,10,8,0,6,0,67
23-05,9,6,10,2,3,0,3,0,33
23-06,14,9,3,4,6,1,6,0,43
23-07,16,7,6,5,8,0,7,0,49
23-08,9,15,5,7,11,1,11,0,59
23-09,17,21,11,10,18,2,7,0,86
23-10,26,25,8,15,20,2,10,0,106
23-11,18,7,3,10,4,2,3,0,47
23-12,10,3,3,5,4,0,3,0,28
23-13,29,27,5,8,19,3,22,0,113
23-14,5,13,6,2,9,2,21,0,58
23-15,11,6,0,0,2,1,12,0,32
23-16,13,6,4,6,5,0,37,0,71
23-17,22,11,3,8,7,0,14,0,65
23-18,21,13,5,10,12,0,6,0,67
23-19,11,8,2,12,7,1,15,0,56
23-20,16,12,1,13,8,3,14,0,67
23-21,21,15,12,11,9,3,19,0,90
23-22,8,7,2,1,9,1,6,0,34
23-23,6,4,2,0,4,0,12,0,28
24-01,50,16,3,4,10,0,4,0,87
24-02,27,9,8,11,16,0,3,0,74
24-03,44,12,15,12,15,0,5,0,103
24-04,27,10,7,16,5,1,1,0,67
24-05,109,16,2,5,9,0,2,0,143
24-06,67,42,26,21,14,4,1,0,175
24-07,30,7,10,15,9,0,1,0,72
24-08,105,11,10,10,9,4,1,0,150
24-09,23,7,16,17,8,0,1,1,73
24-10,11,2,0,2,3,0,0,0,18
24-11,23,8,10,12,3,0,3,0,59
24-12,16,9,8,24,7,1,0,0,65
24-13,22,18,12,19,7,3,1,0,82
24-14,19,14,13,13,7,1,1,0,68
24-15,9,8,7,12,9,0,0,0,45
24-16,14,3,4,12,4,0,1,0,38
24-17,11,6,5,7,4,2,0,0,35
24-18,26,8,2,1,2,2,1,0,42
24-19,11,4,3,0,1,3,2,0,24
25-01,10,9,6,0,7,2,3,0,37
25-02,11,4,4,2,2,0,2,0,25
25-03,24,15,6,2,10,4,5,0,66
25-04,22,9,7,1,9,0,7,0,55
25-05,23,11,3,0,12,3,5,0,57
25-06,15,8,8,0,8,0,10,0,49
25-07,11,11,12,1,10,0,11,0,56
25-08,19,10,3,2,5,0,4,0,43
25-09,4,3,4,4,4,0,2,0,21
25-10,16,11,4,0,4,1,4,0,40
25-11,16,6,8,1,1,0,4,0,36
25-12,14,11,4,3,3,0,13,0,48
25-13,5,8,11,3,2,0,1,0,30
25-14,6,3,2,0,7,0,1,0,19
25-15,3,8,1,1,3,0,2,0,18
25-16,3,2,1,1,1,0,1,0,9
25-17,5,0,2,1,7,0,0,0,15
25-18,8,5,3,3,1,2,1,0,23
25-19,3,4,4,0,5,1,3,0,20
25-20,8,5,3,2,0,0,1,0,19
25-21,4,2,2,2,5,0,0,0,15
25-22,11,9,7,0,10,0,6,0,43
25-23,8,8,4,3,3,0,3,0,29
25-24,11,5,2,0,1,0,3,0,22
26-01,16,12,13,1,13,2,7,0,64
26-02,20,8,14,0,26,0,13,0,81
26-03,11,10,10,0,14,2,11,0,58
26-04,9,2,9,0,20,0,18,0,58
26-05,13,8,5,0,17,1,15,0,59
26-06,4,19,11,1,43,6,27,0,111
26-07,13,6,7,0,18,0,11,0,55
26-08,14,6,6,0,33,2,12,0,73
26-09,7,8,13,0,25,1,15,0,69
26-10,13,6,3,0,18,0,2,0,42
26-11,30,6,7,0,28,1,15,0,87
26-12,22,11,4,2,8,0,14,0,61
26-13,11,13,4,1,23,0,10,0,62
26-14,23,14,6,1,27,0,3,0,74
26-15,10,14,3,1,23,1,15,0,67
26-16,44,12,6,0,8,0,6,0,76
26-17,51,10,5,2,13,2,3,0,86
26-18,22,20,4,1,23,2,11,0,83
26-19,25,14,4,0,14,4,16,0,77
26-20,8,5,1,0,5,0,3,0,22
26-21,22,6,3,2,8,0,3,0,44
26-22,31,12,3,3,20,2,3,0,74
26-23,23,25,9,9,51,3,18,0,138
27-01,68,19,2,1,5,1,0,0,96
27-02,158,31,3,3,11,1,0,0,207
27-03,29,4,0,0,2,0,0,0,35
27-04,31,11,10,9,10,2,1,0,74
27-05,62,15,2,2,2,1,0,0,84
27-06,56,11,0,4,3,0,0,0,74
27-07,102,12,4,8,2,1,2,0,131
27-08,30,2,0,0,1,0,0,0,33
27-09,56,10,2,3,4,0,2,0,77
27-10,62,13,0,3,6,3,0,0,87
27-11,33,7,0,1,4,0,1,0,46
27-12,38,8,9,9,5,0,1,0,70
27-13,59,17,0,4,4,0,0,0,84
27-14,121,21,3,4,8,3,1,0,161
27-15,80,12,9,9,9,1,3,0,123
27-16,56,8,7,5,10,0,3,0,89
27-17,37,14,4,8,9,0,1,0,73
27-18,25,5,1,0,2,1,0,0,34
27-19,17,8,1,2,6,1,1,0,36
27-20,21,4,2,1,2,1,1,0,32
27-21,19,3,0,1,3,0,0,0,26
27-22,21,5,2,5,2,1,0,0,36
27-23,177,30,0,4,12,1,2,0,226
28-01,6,5,4,11,6,0,1,0,33
28-02,16,16,9,11,11,1,2,0,66
28-03,14,8,9,12,21,1,6,0,71
28-04,15,5,2,14,18,0,3,0,57
28-05,16,9,13,14,11,1,8,0,72
28-06,10,10,4,10,23,0,4,0,61
28-07,9,7,6,12,8,2,3,0,47
28-08,28,22,16,25,23,1,4,0,119
28-09,17,17,17,14,14,1,2,0,82
28-10,10,7,12,10,12,0,3,0,54
28-11,10,10,8,21,13,1,1,0,64
28-12,8,9,15,21,4,0,1,0,58
28-13,13,16,9,17,11,0,8,0,74
28-14,20,4,7,8,14,0,1,0,54
28-15,12,5,3,9,12,1,2,0,44
28-16,15,10,4,13,9,1,4,0,56
28-17,14,16,4,6,9,2,14,0,65
28-18,20,7,12,12,8,3,6,0,68
29-01,49,6,2,3,18,0,4,0,82
29-02,5,6,4,2,7,0,0,0,24
29-03,101,13,1,11,30,2,0,0,158
29-04,2,6,1,10,8,0,0,0,27
29-05,18,5,2,6,3,0,0,0,34
29-06,9,5,2,12,9,0,0,0,37
29-07,1,1,0,1,2,0,0,0,5
29-08,7,7,1,3,10,1,0,0,29
29-09,5,2,9,6,10,0,0,0,32
29-10,90,28,16,17,16,5,6,0,178
29-11,38,13,3,10,14,1,1,0,80
29-12,45,14,6,14,44,0,1,0,124
29-13,22,21,14,18,31,1,0,0,107
29-14,19,5,11,10,6,1,1,0,53
29-15,26,13,6,15,8,1,0,0,69
29-16,32,10,3,19,11,0,0,0,75
29-17,33,8,4,8,21,2,0,0,76
29-18,26,7,1,6,46,0,0,0,86
30-01,86,102,12,12,41,3,2,0,258
30-02,55,77,8,9,8,3,3,0,163
30-03,64,78,5,2,12,1,1,0,163
30-04,37,29,1,7,8,0,1,0,83
30-05,52,40,6,9,19,2,4,0,132
30-06,102,85,4,13,29,3,5,0,241
30-07,161,125,5,5,34,1,1,0,332
30-08,89,127,3,2,29,0,4,0,254
30-09,100,86,1,4,18,2,3,0,214
30-10,57,43,3,5,14,1,6,0,129
30-11,68,53,1,7,15,2,4,0,150
30-12,61,50,5,6,18,4,1,0,145
30-13,93,63,5,15,15,1,5,0,197
30-14,73,76,3,6,21,6,2,0,187
30-15,86,86,6,8,18,0,4,0,208
30-16,85,110,6,5,33,1,10,0,250
30-17,98,98,17,5,37,4,4,0,263
31-01,134,16,1,2,2,0,3,0,158
31-02,6,3,0,0,2,0,0,0,11
31-03,69,28,5,0,6,3,1,0,112
31-04,74,32,4,2,8,3,6,0,129
31-05,72,40,6,0,15,0,14,0,147
31-06,55,12,5,2,10,1,2,0,87
31-07,50,42,7,3,14,3,18,0,137
31-08,83,15,6,1,9,1,6,0,121
31-09,90,18,0,0,6,0,1,0,115
31-10,44,12,1,1,5,2,3,1,69
31-11,80,10,3,2,9,3,8,0,115
31-12,41,19,3,3,5,0,3,0,74
31-13,72,26,3,0,8,1,11,0,121
31-14,62,40,3,0,13,1,8,0,127
31-15,57,26,9,2,12,1,4,0,111
31-16,62,47,8,0,9,1,7,0,134
31-17,32,35,2,0,15,0,6,0,90
31-18,50,22,2,0,6,1,12,0,93
31-19,38,24,7,1,15,0,19,0,104
32-01,5,4,2,6,6,0,1,0,24
32-02,14,5,1,15,4,2,0,0,41
32-03,15,7,10,14,14,1,1,0,62
32-04,19,6,7,8,13,0,1,0,54
32-05,15,0,1,2,1,0,0,0,19
32-06,25,8,8,3,5,0,0,0,49
32-07,26,7,1,3,2,0,1,0,40
32-08,17,4,3,10,4,0,0,0,38
32-09,22,1,9,9,3,0,3,0,47
32-10,25,10,7,21,8,1,0,0,72
32-11,37,11,6,11,6,0,0,0,71
32-12,22,12,6,5,7,0,2,0,54
32-13,9,3,5,8,5,0,2,0,32
32-14,8,3,4,7,1,0,0,0,23
32-15,10,9,7,11,14,0,1,0,52
32-16,10,5,12,14,11,0,2,0,54
32-17,6,9,8,13,9,0,3,0,48
32-18,15,10,2,10,6,0,1,0,44
32-19,17,17,17,15,12,2,1,0,81
32-20,10,4,8,25,8,1,0,0,56
32-21,24,11,10,24,11,0,3,1,84
32-22,14,8,7,22,4,1,4,0,60
32-23,18,8,8,22,14,1,1,0,72
32-24,13,15,6,21,14,1,0,0,70
32-25,17,9,9,18,1,3,2,0,59
32-26,10,6,3,18,13,1,0,0,51
32-27,11,7,3,10,6,0,1,0,38
32-28,15,21,8,28,19,1,3,0,95
32-29,5,5,1,27,4,0,2,0,44
32-30,20,6,10,35,5,2,0,0,78
32-31,26,8,10,21,14,1,1,0,81
33-01,13,3,3,3,7,1,0,0,30
33-02,8,3,2,1,8,0,3,0,25
33-03,7,7,2,1,9,1,4,0,31
33-04,11,2,5,5,4,0,3,0,30
33-05,11,10,8,4,6,1,0,0,40
33-06,9,3,1,1,7,2,2,0,25
33-07,5,11,2,6,6,0,1,0,31
33-08,5,12,1,0,2,0,4,0,24
33-09,7,15,3,3,7,4,0,0,39
33-10,5,4,0,3,6,0,2,0,20
33-11,5,4,3,5,7,0,0,0,24
33-12,5,1,3,2,12,0,1,0,24
33-13,2,12,5,4,6,1,2,0,32
33-14,5,10,1,1,8,0,1,0,26
33-15,3,6,1,3,7,0,1,0,21
33-16,4,3,0,2,2,0,1,0,12
33-17,6,1,3,0,2,0,0,0,12
33-18,2,6,2,2,3,0,0,0,15
33-19,3,12,1,1,5,0,0,0,22
33-20,6,3,0,0,5,0,0,0,14
33-21,8,6,0,2,3,1,0,0,20
33-22,5,8,1,2,2,0,0,0,18
33-23,2,1,4,0,4,1,4,0,16
33-24,4,3,0,0,3,0,1,0,11
34-01,16,10,5,18,5,0,1,0,55
34-02,29,17,7,25,12,3,6,0,99
34-03,19,22,3,25,3,1,5,0,78
34-04,15,9,9,28,11,1,1,0,74
34-05,29,8,3,24,3,1,4,0,72
34-06,28,23,9,24,15,1,23,0,123
34-07,41,18,11,50,13,4,6,0,143
34-08,51,20,5,55,11,1,0,0,143
34-09,21,7,6,31,6,1,6,0,78
34-10,28,17,14,35,12,1,0,0,107
34-11,46,15,9,31,11,2,0,0,114
34-12,55,17,13,60,13,3,3,1,165
34-13,56,17,12,25,13,2,1,0,126
34-14,65,20,9,49,10,1,1,0,155
34-15,31,10,10,45,10,1,0,0,107
34-16,16,12,4,8,7,1,2,0,50
34-17,24,10,10,32,7,1,1,0,85
34-18,38,23,3,24,11,2,3,0,104
34-19,70,20,8,44,14,4,4,0,164
34-20,27,12,8,42,12,1,0,0,102
34-21,58,20,17,44,15,2,3,0,159
34-22,42,20,10,31,13,4,2,0,122
34-23,86,28,14,13,53,4,5,0,203
34-24,70,34,15,37,28,0,4,0,188
34-25,62,31,10,19,10,3,3,0,138
34-26,18,11,7,16,2,0,0,0,54
34-27,47,21,8,32,18,0,1,0,127
34-28,55,17,5,28,16,3,6,0,130
34-29,41,15,11,43,14,1,0,0,125
34-30,45,22,10,29,19,1,0,0,126
34-31,43,25,15,31,15,0,1,0,130
34-32,30,16,10,22,10,1,2,0,91
34-33,32,19,7,50,20,1,3,0,132
34-34,64,48,17,34,28,5,4,0,200
34-35,20,15,8,23,11,2,0,0,79
34-36,24,9,11,17,7,1,0,0,69
34-37,29,15,9,26,11,1,4,0,95
34-38,24,7,9,13,5,2,3,0,63
34-39,42,20,11,34,14,5,2,0,128
34-40,41,11,5,24,13,1,0,0,95
34-41,80,30,17,37,20,4,5,0,193
34-42,26,22,3,27,3,3,2,0,86
35-01,21,18,8,3,16,3,4,0,73
35-02,19,8,4,9,12,2,2,0,56
35-03,8,13,10,5,12,2,7,0,57
35-04,12,6,5,6,7,0,5,0,41
35-05,21,24,13,5,34,1,10,0,108
35-06,14,7,2,12,16,0,1,0,52
35-07,29,12,6,9,19,0,9,0,84
35-08,22,17,4,7,17,0,8,0,75
35-09,23,13,14,11,13,1,5,0,80
35-10,21,13,4,6,17,0,2,0,63
35-11,20,8,8,13,7,0,1,0,57
35-12,12,8,3,15,12,0,7,0,57
35-13,14,15,11,9,7,1,2,0,59
35-14,9,13,6,5,10,0,1,0,44
35-15,8,5,1,9,4,0,1,0,28
35-16,12,4,6,12,9,2,4,0,49
35-17,5,8,5,9,7,3,7,0,44
35-18,25,9,1,13,16,2,2,0,68
35-19,11,17,5,10,13,1,6,0,63
35-20,22,10,3,4,10,0,3,0,52
35-21,14,5,2,16,8,0,0,0,45
35-22,11,9,3,5,6,1,0,0,35
35-23,19,11,8,7,11,1,4,0,61
35-24,13,9,5,3,5,1,2,0,38
35-25,19,10,5,11,3,0,1,0,49
35-26,7,4,2,6,9,1,1,0,30
35-27,6,6,1,6,5,0,1,0,25
35-28,8,6,16,1,6,3,0,0,40
35-29,11,12,0,5,10,0,1,0,39
35-30,7,3,6,3,6,1,0,0,26
35-31,9,8,5,12,14,0,5,0,53
35-32,14,10,10,6,15,2,4,0,61
36-01,56,19,11,8,17,1,5,0,117
36-02,50,18,9,14,16,2,1,0,110
36-03,67,17,7,13,26,2,2,0,134
36-04,22,13,3,17,19,2,0,0,76
36-05,76,21,7,21,16,2,1,0,144
36-06,65,9,6,16,19,3,0,0,118
36-07,52,26,7,20,16,3,1,0,125
36-08,46,14,11,15,17,2,1,0,106
36-09,68,16,5,1,16,0,2,0,108
36-10,36,25,9,14,12,3,0,0,99
36-11,24,19,13,21,13,0,0,0,90
36-12,28,5,2,6,16,0,0,0,57
36-13,32,13,4,15,10,2,2,0,78
36-14,6,8,5,10,11,1,6,0,47
36-15,18,11,4,20,19,2,0,0,74
36-16,28,9,12,21,36,0,0,0,106
36-17,23,9,7,19,7,1,1,0,67
36-18,34,6,7,18,6,1,2,0,74
36-19,21,19,21,15,17,0,1,0,94
36-20,42,5,3,12,16,1,1,0,80
36-21,23,13,7,17,3,0,1,0,64
36-22,32,4,5,8,10,0,0,0,59
36-23,18,9,5,24,7,2,1,0,66
36-24,11,6,6,7,12,0,1,0,43
36-25,11,12,8,7,20,2,4,0,64
36-26,9,11,8,10,12,4,7,0,61
36-27,12,7,5,4,15,0,14,0,57
36-28,25,9,11,21,16,4,0,0,86
36-29,65,7,0,3,34,0,2,0,111
36-30,17,8,6,10,18,2,0,0,61
36-31,37,13,8,8,13,1,0,0,80
36-32,26,11,11,23,23,0,3,0,97
36-33,21,7,4,11,13,0,5,0,61
36-34,52,19,3,3,11,2,4,0,94
36-35,69,29,13,25,20,4,5,0,165
36-36,88,27,5,27,35,1,4,0,187
36-37,83,40,11,17,14,3,4,0,172
36-38,44,15,7,11,18,0,3,0,98
36-39,67,13,6,14,13,2,6,0,121
36-40,72,22,6,19,40,0,1,0,160
36-41,49,12,1,4,16,0,1,0,83
37-01,11,2,3,10,7,0,1,0,34
37-02,25,3,8,8,9,3,0,0,56
37-03,12,8,5,6,13,0,0,0,44
37-04,18,8,6,6,1,1,1,0,41
37-05,15,15,5,11,12,0,2,0,60
37-06,10,4,3,10,5,0,0,0,32
37-07,12,9,16,5,7,0,1,0,50
37-08,31,3,4,9,3,0,0,0,50
37-09,18,4,7,6,3,0,0,0,38
37-10,21,16,14,9,16,4,0,0,80
37-11,36,5,7,13,6,1,1,0,69
37-12,31,6,3,2,6,0,1,0,49
37-13,7,11,9,6,13,0,0,0,46
37-14,31,2,3,15,7,0,6,0,64
37-15,16,3,0,6,2,0,0,0,27
37-16,7,2,3,6,8,0,0,0,26
37-17,25,1,4,3,4,0,0,0,37
37-18,22,4,1,0,3,2,0,0,32
37-19,11,9,0,3,7,1,0,0,31
37-20,4,11,4,2,4,0,0,0,25
37-21,8,18,8,5,8,0,0,0,47
38-01,4,1,3,51,28,0,0,0,87
38-02,33,33,21,18,33,1,0,0,139
38-03,33,15,6,37,10,1,1,0,103
38-04,19,10,7,13,13,0,0,0,62
38-05,22,9,4,8,36,1,0,0,80
38-06,21,16,11,15,40,0,1,0,104
38-07,22,29,5,16,39,0,0,0,111
38-08,23,17,9,16,30,2,1,0,98
38-09,53,29,6,23,26,4,1,0,142
38-10,30,20,7,26,22,2,2,0,109
38-11,48,40,7,2,84,0,3,0,184
38-12,51,15,5,5,39,4,2,0,121
38-13,59,49,3,0,71,3,5,0,190
38-14,57,20,8,3,30,2,3,0,123
38-15,51,30,5,5,21,2,4,0,118
38-16,51,20,2,0,52,1,3,0,129
38-17,53,26,9,26,13,0,0,0,127
38-18,60,51,5,3,66,0,8,0,193
38-19,14,17,8,17,16,1,1,0,74
38-20,33,21,1,0,27,1,6,0,89
38-21,31,17,5,18,24,3,4,0,102
39-01,34,15,6,1,10,1,5,0,72
39-02,9,7,3,3,3,1,66,0,92
39-03,20,13,10,0,15,1,59,0,118
39-04,20,9,5,0,7,0,8,0,49
39-05,37,17,9,3,7,1,3,0,77
39-06,20,17,8,0,23,3,80,0,151
39-07,18,10,8,1,21,2,144,0,204
39-08,26,15,5,1,24,3,36,0,110
39-09,21,4,10,5,4,2,16,0,62
39-10,36,8,19,11,8,3,8,0,93
39-11,8,5,1,0,6,0,31,0,51
39-12,7,3,5,2,5,0,4,0,26
39-13,19,8,5,8,10,1,15,0,66
39-14,7,8,5,0,10,3,9,0,42
39-15,12,15,12,0,26,1,80,0,146
39-16,11,0,3,4,11,2,2,0,33
39-17,16,5,5,6,0,0,10,0,42
39-18,15,6,5,0,7,1,19,0,53
39-19,13,8,2,2,10,0,5,0,40
39-20,18,16,9,0,20,1,74,0,138
39-21,20,16,9,0,12,2,75,0,134
39-22,25,14,10,2,16,3,18,0,88
39-23,8,2,2,3,4,1,24,0,44
39-24,26,22,12,7,13,0,50,0,130
39-25,35,22,9,0,23,5,11,0,105
39-26,91,18,15,0,23,1,11,0,159
39-27,78,12,11,1,17,2,6,0,127
39-28,45,8,10,2,3,1,63,0,132
39-29,9,10,7,0,6,1,29,0,62
39-30,110,21,7,2,19,1,4,0,164
39-31,23,11,13,1,19,1,13,0,81
39-32,46,3,6,2,9,1,4,0,71
39-33,19,9,9,2,22,1,13,0,75
39-34,31,20,27,1,10,0,1,0,90
39-35,74,19,8,1,20,1,6,0,129
39-36,15,7,9,0,16,2,25,0,74
39-37,63,18,13,0,18,3,4,0,119
39-38,63,19,9,1,16,3,10,0,121
39-39,19,15,27,0,21,1,5,0,88
39-40,31,3,3,6,2,1,3,0,49
39-41,14,7,7,1,22,3,15,0,69
39-42,37,9,10,0,13,1,10,0,80
39-43,29,6,9,0,8,1,8,0,61
39-44,14,7,7,1,18,1,9,0,57
39-45,138,19,17,0,23,2,17,0,216
39-46,135,33,12,1,25,3,16,0,225
40-01,16,5,2,13,1,1,4,0,42
40-02,17,4,8,15,6,3,3,0,56
40-03,49,11,6,26,7,1,41,0,141
40-04,16,39,7,12,6,0,4,0,84
40-05,39,13,8,38,6,0,10,0,114
40-06,16,9,1,4,3,0,4,0,37
40-07,22,9,11,12,11,2,4,0,71
40-08,19,8,4,7,7,0,6,0,51
40-09,24,8,6,15,11,0,9,0,73
40-10,10,3,6,5,2,1,2,0,29
40-11,15,7,5,16,3,1,8,0,55
40-12,19,4,1,15,3,0,5,0,47
40-13,17,11,3,9,13,0,10,0,63
40-14,19,9,4,6,5,0,9,0,52
40-15,7,4,1,10,9,1,3,0,35
40-16,17,10,3,12,4,0,0,0,46
40-17,14,2,1,9,3,0,8,0,37
40-18,7,5,4,8,1,1,5,0,31
40-19,7,9,0,6,1,0,9,0,32
40-20,5,5,2,5,4,0,4,0,25
40-21,6,4,1,3,3,0,8,0,25
40-22,9,6,4,13,7,1,11,0,51
40-23,10,2,7,21,7,1,4,0,52
40-24,21,11,1,42,5,1,0,0,81
40-25,16,6,5,15,10,1,13,0,66
40-26,8,4,7,11,7,2,5,0,44
40-27,17,3,1,13,3,0,4,0,41
40-28,17,12,5,31,7,1,24,0,97
40-29,14,3,2,15,9,0,8,0,51
40-30,29,10,2,13,14,1,5,0,74
40-31,17,4,3,22,5,1,11,0,63
40-32,26,12,8,17,17,0,16,0,96
40-33,10,5,8,10,4,2,5,0,44
40-34,12,11,6,11,3,1,10,0,54
40-35,30,2,3,10,7,0,1,0,53
40-36,12,7,7,10,4,1,3,0,44
40-37,36,10,8,12,11,2,27,0,106
40-38,56,33,17,16,15,0,18,0,155
40-39,16,6,3,11,1,0,9,0,46
40-40,68,32,20,20,13,3,12,0,168
40-41,15,6,3,16,1,1,27,0,69
40-42,36,9,7,16,10,1,8,0,87
40-43,12,4,5,8,10,2,10,0,51
40-44,46,17,5,19,16,5,23,0,131
40-45,75,15,9,23,9,1,14,0,146
40-46,43,20,11,16,21,0,17,0,128
40-47,5,8,4,6,1,0,6,0,30
40-48,28,15,7,25,15,1,32,0,123
40-49,40,15,12,14,15,0,23,0,119
40-50,21,21,7,23,9,0,33,0,114
40-51,12,5,0,13,8,2,1,0,41
41-01,8,4,2,4,7,0,2,0,27
41-02,8,10,3,4,2,0,1,0,28
41-03,8,9,4,2,8,1,3,0,35
41-04,3,10,9,2,8,0,5,0,37
41-05,9,6,3,2,3,1,1,0,25
41-06,8,12,2,3,8,1,7,0,41
41-07,4,6,3,2,6,1,1,0,23
41-08,3,8,5,2,8,0,2,0,28
41-09,4,4,7,4,4,2,2,0,27
41-10,6,8,8,3,4,2,5,0,36
41-11,2,6,4,2,6,0,3,0,23
41-12,5,7,6,2,2,0,6,0,28
41-13,13,11,11,3,4,1,7,0,50
41-14,7,9,8,6,9,2,7,0,48
41-15,12,13,8,5,12,7,5,0,62
41-16,4,9,6,2,7,4,1,0,33
41-17,9,7,14,0,5,7,9,0,51
41-18,5,11,5,0,8,3,7,0,39
41-19,7,8,6,1,5,1,6,0,34
41-20,2,7,5,4,9,0,3,0,30
41-21,15,6,7,5,8,2,3,0,46
41-22,8,17,4,3,8,2,2,0,44
41-23,5,9,3,3,10,2,13,0,45
41-24,4,9,2,3,10,1,9,0,38
41-25,7,16,6,4,8,0,5,0,46
41-26,7,9,3,4,5,2,10,0,40
42-01,24,9,3,5,12,1,0,0,54
42-02,18,3,1,3,1,1,1,0,28
42-03,12,6,1,4,20,2,1,0,46
42-04,15,0,1,4,4,0,1,0,25
42-05,24,6,4,8,7,1,0,0,50
42-06,12,5,3,6,7,0,0,0,33
42-07,18,6,1,7,6,1,0,0,39
42-08,17,4,1,8,11,1,0,0,42
42-09,11,10,0,3,8,3,0,0,35
42-10,8,8,4,1,4,1,3,0,29
42-11,17,7,4,8,9,3,0,0,48
42-12,14,7,3,5,4,1,1,0,35
42-13,53,12,14,12,10,2,1,0,104
42-14,21,10,3,5,8,0,1,0,48
42-15,38,15,10,11,11,2,0,0,87
42-16,20,11,2,5,7,0,0,0,45
42-17,35,8,4,13,11,1,0,0,72
42-18,35,16,5,12,10,0,2,0,80
42-19,29,15,1,8,5,0,0,0,58
42-20,31,9,4,11,5,0,0,0,60
42-21,19,4,5,5,0,0,0,0,33
42-22,13,4,4,6,5,0,1,0,33
42-23,6,4,2,8,3,1,0,0,24
42-24,45,10,3,10,11,0,1,0,80
42-25,32,10,3,17,9,1,0,0,72
43-01,9,17,7,7,8,1,0,0,49
43-02,46,6,7,6,20,0,1,0,86
43-03,5,1,1,4,11,0,1,0,23
43-04,16,6,6,3,8,1,1,0,41
43-05,21,2,0,7,4,1,0,0,35
43-06,8,2,1,4,9,0,3,0,27
43-07,8,8,2,3,17,0,0,0,38
43-08,5,7,2,5,7,0,0,0,26
43-09,21,7,3,9,12,2,0,0,54
43-10,9,7,11,14,3,0,0,0,44
43-11,0,0,2,1,9,0,0,0,12
43-12,9,6,0,4,7,1,1,0,28
43-13,22,6,6,6,10,2,0,0,52
43-14,16,6,4,10,6,1,1,0,44
43-15,9,15,13,9,5,0,1,0,52
43-16,17,6,10,5,10,0,1,0,49
43-17,4,0,2,2,7,0,0,0,15
43-18,1,7,4,4,22,0,1,0,39
43-19,13,10,3,2,10,1,4,0,43
43-20,4,6,3,2,13,0,1,0,29
43-21,19,13,4,11,7,0,2,0,56
43-22,12,7,7,15,12,1,0,0,54
43-23,16,20,3,13,12,0,0,0,64
43-24,43,7,6,13,7,1,0,0,77
43-25,14,7,4,5,15,0,0,0,45
44-01,22,5,7,26,10,1,0,0,71
44-02,32,10,6,31,14,0,0,0,93
44-03,17,15,5,30,5,0,1,0,73
44-04,17,8,8,19,5,2,0,0,59
44-05,15,16,10,9,9,1,1,0,61
44-06,34,14,9,34,12,2,3,0,108
44-07,30,12,4,29,3,1,4,0,83
44-08,29,13,5,15,8,1,0,0,71
44-09,23,12,10,23,12,0,0,0,80
44-10,25,8,3,25,5,1,2,0,69
44-11,43,6,12,14,9,0,0,0,84
44-12,31,9,7,6,6,0,0,0,59
44-13,28,13,7,15,10,1,0,0,74
44-14,39,8,4,25,9,1,2,0,88
44-15,27,16,4,16,2,1,1,0,67
44-16,18,7,6,17,7,1,0,0,56
44-17,29,8,7,17,4,0,0,0,65
44-18,29,17,8,15,6,0,1,0,76
44-19,29,10,8,11,16,1,0,0,75
45-01,8,11,5,0,10,0,11,0,45
45-02,5,10,3,0,11,1,2,0,32
45-03,6,5,6,0,11,0,3,0,31
45-04,9,12,10,0,11,6,19,0,67
45-05,12,3,5,3,17,1,11,1,53
45-06,2,6,3,1,9,0,7,0,28
45-07,13,9,9,0,14,1,2,0,48
45-08,6,9,3,0,9,2,1,0,30
45-09,1,2,1,3,2,0,2,0,11
45-10,0,1,0,0,1,1,0,0,3
45-11,2,6,5,0,3,0,0,0,16
45-12,1,4,3,0,1,0,3,0,12
45-13,1,3,1,3,5,2,4,0,19
45-14,3,0,1,0,1,0,0,0,5
45-15,19,15,8,1,11,0,17,0,71
45-16,1,5,3,3,4,1,1,0,18
45-17,14,3,2,2,4,1,0,0,26
45-18,2,3,1,2,6,1,0,0,15
45-19,2,0,3,0,7,0,1,0,13
45-20,10,14,6,0,16,7,15,0,68
45-21,1,8,5,1,2,0,1,0,18
45-22,7,16,6,0,16,0,11,0,56
45-23,12,19,7,0,17,2,6,0,63
45-24,8,12,5,1,17,2,12,0,57
45-25,2,11,4,0,12,0,8,0,37
46-01,250,39,1,2,23,3,0,0,318
46-02,182,13,6,12,9,0,0,0,222
46-03,139,21,13,23,5,1,0,0,202
46-04,54,12,4,10,3,0,0,0,83
46-05,52,18,7,41,8,1,0,0,127
46-06,47,19,6,36,16,1,1,0,126
46-07,178,12,4,9,9,1,3,0,216
46-08,229,40,4,7,11,2,0,0,293
46-09,218,21,5,7,9,2,1,0,263
46-10,116,18,4,20,5,1,3,0,167
46-11,76,13,11,41,5,1,0,0,147
46-12,58,13,6,29,17,1,0,0,124
46-13,38,20,10,33,13,1,1,0,116
46-14,23,14,7,16,3,1,0,0,64
46-15,29,18,9,24,3,1,0,0,84
46-16,230,46,4,5,24,1,4,0,314
46-17,335,56,3,7,15,5,3,0,424
46-18,175,18,4,7,9,0,4,0,217
46-19,236,59,5,10,22,1,3,0,336
46-20,33,16,8,21,6,1,0,0,85
46-21,36,11,5,25,5,1,0,0,83
46-22,131,28,4,24,14,1,0,0,202
46-23,193,29,1,10,7,6,1,0,247
47-01,50,20,3,6,3,0,0,0,82
47-02,34,17,12,6,5,1,2,0,77
47-03,43,11,9,5,3,0,5,0,76
47-04,19,8,3,5,10,0,3,0,48
47-05,23,7,3,13,6,1,8,0,61
47-06,23,7,2,3,5,2,4,0,46
47-07,28,10,9,8,2,1,10,0,68
47-08,16,9,4,15,6,0,6,0,56
47-09,14,5,2,2,3,0,2,0,28
47-10,11,1,5,4,4,0,1,0,26
47-11,10,10,10,11,12,1,1,0,55
47-12,10,3,1,4,0,0,1,0,19
47-13,20,10,10,17,8,2,0,0,67
47-14,3,6,3,9,3,1,0,0,25
48-01,36,13,7,7,6,1,3,0,73
48-02,52,9,5,14,6,1,1,0,88
48-03,45,15,12,23,14,1,1,0,111
48-04,24,13,11,18,12,1,3,0,82
48-05,27,6,10,11,13,2,2,0,71
48-06,29,24,5,16,5,2,1,0,82
48-07,9,17,17,5,14,2,3,0,67
48-08,32,11,15,16,9,0,1,0,84
48-09,22,9,2,9,6,1,0,0,49
48-10,6,1,9,8,6,1,6,0,37
48-11,7,2,2,3,0,1,0,0,15
48-12,26,10,6,10,12,2,2,0,68
48-13,37,12,5,4,9,0,1,0,68
48-14,38,4,7,1,6,2,7,0,65
48-15,6,4,1,7,1,1,1,0,21
48-16,20,17,6,12,13,3,0,0,71
48-17,36,13,16,4,4,3,0,0,76
48-18,44,12,7,0,15,1,0,0,79
48-19,12,4,3,1,3,1,6,0,30
48-20,77,14,2,2,3,1,1,0,100
48-21,29,19,37,19,40,2,2,0,148
48-22,6,4,1,2,4,0,2,0,19
48-23,13,13,11,9,10,3,3,0,62
49-01,9,5,3,5,4,16,2,0,44
49-02,39,17,14,20,15,2,3,0,110
49-03,72,25,8,36,12,8,3,0,164
49-04,31,16,14,13,7,2,1,0,84
49-05,23,23,11,15,7,16,0,0,95
49-06,66,15,16,21,13,9,3,0,143
49-07,40,25,17,32,5,6,1,0,126
49-08,56,30,15,39,19,2,1,0,162
49-09,20,26,4,19,19,16,3,0,107
49-10,31,18,18,18,8,8,1,0,102
49-11,22,16,6,15,14,4,5,0,82
49-12,27,23,8,14,13,3,3,0,91
49-13,8,8,0,11,5,2,1,0,35
49-14,28,9,8,18,13,2,0,0,78
49-15,22,14,10,16,7,5,0,0,74
49-16,26,25,8,28,8,8,0,0,103
49-17,36,18,8,25,10,10,2,0,109
49-18,60,28,2,9,19,14,5,0,137
49-19,31,7,6,24,13,5,0,0,86
49-20,46,36,17,25,2,5,2,0,133
49-21,34,37,7,21,21,14,3,1,138
49-22,42,24,23,22,13,2,0,0,126
50-01,64,25,10,36,9,0,0,0,144
50-02,84,31,8,56,9,3,4,0,195
50-03,93,36,10,34,8,2,1,0,184
50-04,87,12,6,31,13,1,1,0,151
50-05,107,23,7,31,9,0,2,0,179
50-06,89,23,10,16,7,0,0,0,145
50-07,111,38,9,42,5,2,0,0,207
50-08,110,26,8,32,6,0,0,0,182
50-09,109,43,13,49,15,1,4,0,234
50-10,87,16,5,21,15,0,2,0,146
50-11,68,16,5,20,13,1,0,0,123
50-12,119,29,5,22,6,1,3,0,185
50-13,75,21,9,21,7,1,1,0,135
50-14,72,18,6,24,8,0,0,0,128
50-15,101,16,10,22,11,0,0,0,160
50-16,78,26,7,34,15,2,5,0,167
50-17,82,24,11,33,9,1,0,0,160
50-18,81,21,3,33,11,1,1,0,151
50-19,127,38,9,51,15,1,0,0,241
50-20,88,13,13,30,5,1,4,0,154
50-21,122,30,15,36,31,0,0,0,234
50-22,108,21,8,29,9,0,0,0,175
50-23,80,18,3,37,4,1,0,0,143
50-24,92,26,8,36,6,0,3,0,171
50-25,72,11,8,13,5,1,0,0,110
50-26,91,23,11,18,9,3,1,0,156
50-27,127,28,3,33,10,2,2,0,205
50-28,46,8,5,6,2,0,0,0,67
50-29,139,17,5,21,11,1,2,0,196
50-30,70,20,5,28,10,0,2,0,135
51-01,30,8,29,12,6,1,2,0,88
51-02,50,6,1,13,4,0,3,0,77
51-03,16,8,7,10,5,1,3,0,50
51-04,32,10,15,15,5,2,0,0,79
51-05,98,9,11,15,7,0,2,0,142
51-06,203,13,8,7,6,0,3,0,240
51-07,43,14,11,11,3,0,1,0,83
51-08,28,16,2,12,6,2,1,0,67
51-09,6,10,13,13,7,0,3,0,52
51-10,29,9,10,7,3,0,1,0,59
51-11,21,16,27,9,7,0,3,0,83
51-12,26,19,15,15,3,4,1,0,83
51-13,14,7,9,14,7,3,3,0,57
51-14,123,16,18,17,8,0,3,0,185
51-15,44,18,12,27,6,1,0,0,108
51-16,25,10,9,27,5,1,1,0,78
51-17,32,5,20,14,11,2,0,0,84
51-18,35,11,18,13,5,4,0,0,86
51-19,17,8,8,17,6,2,0,0,58
51-20,32,7,10,19,5,1,0,0,74
51-21,15,7,6,10,2,0,0,0,40
51-22,18,11,11,24,6,0,0,0,70
51-23,31,8,3,12,6,0,2,0,62
51-24,21,7,10,15,9,0,0,0,62
51-25,25,8,13,21,16,2,1,0,86
51-26,28,13,10,17,12,0,1,0,81
51-27,18,12,4,10,3,1,2,0,50
51-28,39,14,9,22,6,1,0,0,91
52-01,26,10,3,14,32,1,1,0,87
52-02,80,30,10,18,21,1,0,0,160
52-03,5,3,0,4,3,0,1,0,16
52-04,26,26,7,5,17,2,0,0,83
52-05,54,26,10,22,24,1,2,0,139
52-06,68,22,9,22,17,3,2,0,143
52-07,55,12,7,17,17,1,0,0,109
52-08,34,25,16,38,36,0,4,0,153
52-09,35,34,15,23,30,1,1,0,139
52-10,91,21,12,18,27,1,0,0,170
52-11,53,19,11,22,23,0,2,0,130
52-12,39,29,17,19,31,1,2,0,138
52-13,64,25,15,23,48,3,3,0,181
52-14,52,31,14,16,24,2,2,0,141
52-15,68,32,23,36,23,0,5,0,187
52-16,60,29,11,30,31,3,7,0,171
52-17,41,25,17,35,11,3,0,0,132
52-18,66,23,10,27,24,0,1,0,151
52-19,59,26,14,31,15,2,7,0,154
52-20,57,32,11,19,24,2,3,0,148
52-21,41,9,10,15,13,0,5,0,93
52-22,46,20,10,14,20,1,1,0,112
52-23,45,9,6,29,22,0,0,0,111
52-24,44,22,6,22,16,3,3,0,116
52-25,68,20,18,43,28,2,1,0,180
52-26,63,30,11,22,25,3,1,0,155
52-27,48,30,13,29,30,1,0,0,151
52-28,21,9,13,6,11,0,1,0,61
53-01,14,10,10,7,6,4,4,0,55
53-02,20,12,8,9,6,1,1,0,57
53-03,8,8,8,6,9,1,4,0,44
53-04,22,17,11,10,7,0,2,0,69
53-05,9,16,7,11,17,2,2,0,64
53-06,10,12,3,5,7,1,1,0,39
53-07,15,3,8,5,8,1,0,0,40
53-08,8,5,3,6,9,0,3,0,34
53-09,14,4,6,1,9,0,0,0,34
53-10,12,4,7,3,11,0,1,0,38
53-11,9,10,8,8,11,2,7,0,55
53-12,14,17,9,7,20,1,7,0,75
53-13,7,13,17,3,10,1,0,0,51
53-14,11,10,8,4,9,1,3,0,46
53-15,20,17,16,3,18,2,12,0,88
53-16,11,14,9,1,26,0,3,0,64
53-17,12,15,4,0,16,1,10,0,58
53-18,12,11,10,9,12,0,10,0,64
53-19,12,17,5,5,15,4,3,0,61
53-20,8,21,8,4,3,2,9,0,55
53-21,8,8,9,0,9,2,3,0,39
53-22,12,23,12,4,13,2,6,0,72
53-23,7,4,5,1,9,0,1,0,27
54-01,10,7,11,3,6,1,4,0,42
54-02,5,6,2,9,5,2,4,0,33
54-03,6,6,6,4,2,0,1,0,25
54-04,13,9,9,4,2,0,2,0,39
54-05,5,7,5,6,3,0,1,0,27
54-06,3,7,3,5,5,2,4,0,29
54-07,5,3,6,4,7,0,5,0,30
54-08,4,3,6,5,10,0,4,0,32
54-09,14,17,6,8,11,1,2,0,59
54-10,3,6,2,1,6,0,5,0,23
54-11,9,10,4,2,4,0,5,0,34
54-12,11,7,3,6,2,1,3,0,33
54-13,5,7,6,7,2,3,3,0,33
54-14,3,4,5,2,10,0,1,0,25
54-15,4,6,3,1,5,0,4,0,23
54-16,4,5,5,6,1,2,3,0,26
54-17,3,8,10,2,10,0,1,0,34
54-18,10,7,9,1,7,2,3,0,39
54-19,9,6,4,4,4,0,4,0,31
54-20,5,6,3,2,8,0,1,0,25
54-21,1,11,14,2,5,3,9,0,45
54-22,6,2,5,2,5,0,8,0,28
55-01,3,9,7,2,4,2,6,0,33
55-02,14,14,10,0,8,1,9,0,56
55-03,5,7,9,3,9,0,13,0,46
55-04,7,8,26,2,13,2,8,0,66
55-05,9,7,13,1,12,2,9,0,53
55-06,7,6,7,0,5,0,2,0,27
55-07,36,14,26,2,14,2,3,0,97
55-08,5,17,10,0,9,2,10,0,53
55-09,3,9,7,0,6,1,4,0,30
55-10,7,11,2,2,5,1,2,0,30
55-11,4,7,10,3,14,0,7,0,45
55-12,2,11,6,3,6,1,8,0,37
55-13,3,5,10,2,6,1,12,0,39
55-14,9,6,6,0,5,1,18,0,45
55-15,1,9,8,2,8,0,9,0,37
55-16,6,8,12,0,16,1,3,0,46
55-17,4,10,10,0,12,1,6,0,43
55-18,3,10,9,0,11,0,4,0,37
55-19,5,15,6,0,5,0,10,0,41
55-20,6,12,10,1,16,3,10,0,58
55-21,5,14,8,0,6,2,10,0,45
55-22,3,5,3,0,9,0,10,0,30
55-23,9,4,6,1,2,2,11,0,35
55-24,3,8,5,3,6,0,9,0,34
55-25,8,4,11,3,8,1,9,0,44
55-26,7,7,11,5,13,2,8,0,53
55-27,6,7,5,4,17,1,7,0,47
55-28,6,5,15,2,7,3,7,0,45
55-29,5,4,14,0,19,0,3,0,45
56-01,7,10,13,0,11,3,22,0,66
56-02,8,8,3,0,16,0,15,0,50
56-03,10,3,5,0,3,0,5,0,26
56-04,11,5,5,2,11,1,2,0,37
56-05,5,7,12,3,9,0,6,0,42
56-06,6,21,31,3,24,2,20,0,107
56-07,12,16,18,4,8,3,7,0,68
56-08,11,19,33,2,15,3,16,0,99
56-09,8,13,15,1,10,0,10,0,57
56-10,14,13,11,2,7,0,12,0,59
56-11,8,12,9,2,5,0,7,0,43
56-12,3,7,13,4,26,1,7,0,61
56-13,12,7,12,0,8,0,6,0,45
56-14,7,7,5,4,10,1,8,0,42
56-15,4,3,13,0,4,1,1,0,26
56-16,5,9,12,2,16,0,8,0,52
56-17,4,7,10,1,15,2,2,0,41
56-18,6,19,14,3,3,3,6,0,54
56-19,10,16,15,9,15,4,15,0,84
56-20,3,11,19,0,6,0,7,0,46
56-21,9,11,10,2,15,4,9,0,60
56-22,5,10,78,1,9,0,2,0,105
56-23,5,12,10,1,14,0,12,0,54
56-24,9,9,13,1,8,0,12,0,52
56-25,15,9,26,2,12,5,12,0,81
56-26,8,12,11,2,18,0,7,0,58
56-27,4,16,12,2,6,1,4,0,45
56-28,4,16,17,1,13,0,8,0,59
56-29,13,17,26,3,6,2,9,0,76
56-30,20,8,16,6,14,2,5,0,71
56-31,8,17,15,2,10,0,4,0,56
56-32,3,6,3,2,10,1,4,0,29
56-33,7,14,8,5,13,3,8,0,58
56-34,12,25,3,4,9,0,1,0,54
56-35,0,11,7,1,12,1,2,0,34
56-36,13,6,11,1,15,1,4,0,51
56-37,4,4,7,3,11,1,6,0,36
56-38,6,16,12,3,10,1,5,0,53
56-39,7,4,7,3,8,0,8,0,37
56-40,5,11,7,1,9,0,6,0,39
56-41,13,23,17,4,8,1,6,0,72
57-01,5,7,12,2,16,1,23,0,66
57-02,8,12,10,1,16,2,25,0,74
57-03,4,19,1,0,10,2,14,0,50
57-04,12,14,7,0,17,7,12,0,69
57-05,6,11,7,0,8,3,11,0,46
57-06,23,23,16,4,12,3,22,0,103
57-07,13,10,7,6,6,2,2,0,46
57-08,15,11,11,3,18,2,15,0,75
57-09,6,5,5,2,14,5,13,0,50
57-10,17,9,9,2,9,1,6,0,53
57-11,8,16,9,0,12,1,21,0,67
57-12,10,15,6,1,20,0,18,0,70
57-13,3,5,7,1,21,1,19,0,57
57-14,6,3,4,0,8,4,26,0,51
57-15,14,9,7,2,15,2,14,0,63
57-16,4,13,6,1,14,2,16,0,56
57-17,6,25,5,1,23,3,20,0,83
57-18,3,20,13,0,16,5,21,0,78
57-19,4,10,9,0,18,0,18,0,59
57-20,7,7,3,0,13,0,3,0,33
57-21,6,12,7,1,13,0,27,0,66
57-22,9,6,9,0,5,2,36,0,67
57-23,11,12,6,3,25,0,17,0,74
57-24,6,3,1,1,9,0,5,0,25
57-25,7,9,5,1,12,2,14,0,50
57-26,11,9,7,5,7,3,7,0,49
57-27,15,13,4,7,8,0,8,0,55
57-28,6,14,8,1,17,3,14,0,63
58-01,8,11,6,2,7,1,6,0,41
58-02,4,6,5,1,3,0,2,0,21
58-03,9,20,10,1,16,2,8,0,66
58-04,5,13,12,1,23,1,25,0,80
58-05,19,14,7,3,25,2,8,0,78
58-06,2,13,11,1,14,1,6,0,48
58-07,8,6,7,0,24,0,8,0,53
58-08,12,22,9,2,14,0,6,0,65
58-09,3,13,13,0,17,1,11,0,58
58-10,10,13,6,1,14,0,7,0,51
58-11,6,10,7,0,8,1,7,0,39
58-12,3,9,6,1,11,2,3,0,35
58-13,6,23,10,1,21,0,3,0,64
58-14,12,8,3,0,9,1,5,0,38
58-15,5,4,2,0,6,2,6,0,25
58-16,5,14,10,0,31,0,20,0,80
58-17,3,26,12,2,21,5,8,0,77
58-18,10,6,6,3,9,0,8,0,42
58-19,10,24,17,0,22,3,10,0,86
58-20,22,9,10,1,14,2,13,0,71
58-21,12,13,7,3,17,1,9,0,62
58-22,2,11,5,1,15,1,9,0,44
58-23,8,19,8,1,28,2,7,0,73
58-24,10,25,17,1,46,1,12,0,112
58-25,7,15,14,2,14,0,7,0,59
58-26,11,17,10,0,30,0,11,0,79
58-27,13,12,9,0,8,3,7,0,52
58-28,5,12,6,0,18,0,8,0,49
58-29,16,15,11,2,36,2,17,0,99
58-30,12,9,7,1,12,0,5,0,46
58-31,4,16,8,4,8,3,5,0,48
58-32,7,11,7,1,3,1,2,0,32
58-33,3,8,6,0,3,1,0,0,21
58-34,17,23,8,0,19,2,8,0,77
58-35,7,24,7,3,29,1,12,0,83
58-36,2,3,7,2,8,0,0,0,22
58-37,7,15,16,2,27,0,7,0,74
58-38,5,0,4,1,4,1,4,0,19
58-39,1,12,7,1,36,3,18,0,78
58-40,5,7,9,0,12,1,4,0,38
58-41,16,16,11,0,37,5,32,0,117
58-42,5,5,9,0,16,3,6,0,44
58-43,4,10,9,0,9,1,9,0,42
58-44,9,29,19,0,22,1,3,0,83
59-01,27,19,6,23,6,0,2,0,83
59-02,42,25,5,37,7,1,1,0,118
59-03,13,18,6,33,9,0,0,0,79
59-04,90,30,11,35,13,1,1,0,181
59-05,27,17,14,38,10,3,2,0,111
59-06,17,13,3,21,13,1,2,0,70
59-07,25,13,7,39,2,0,1,0,87
59-08,18,14,9,43,8,1,1,0,94
59-09,19,13,4,36,4,1,2,0,79
59-10,25,39,13,56,11,1,1,0,146
59-11,33,23,8,22,8,0,2,0,96
59-12,56,24,4,46,6,0,1,0,137
59-13,43,34,6,29,6,1,1,0,120
59-14,23,13,2,26,7,3,0,0,74
59-15,35,17,3,15,3,0,2,0,75
59-16,19,18,3,34,10,1,4,0,89
59-17,124,52,17,16,20,3,1,0,233
59-18,49,26,9,26,5,2,3,0,120
59-19,138,32,4,21,18,0,2,0,215
59-20,23,29,0,1,3,0,0,0,56
59-21,80,26,4,27,13,4,0,0,154
59-22,108,53,6,20,15,0,1,0,203
59-23,56,28,3,24,12,2,0,0,125
59-24,72,25,3,10,9,1,1,0,121
59-25,75,35,9,15,9,2,1,0,146
60-01,34,9,11,7,16,1,2,0,80
60-02,58,26,12,25,9,2,2,0,134
60-03,30,12,14,13,7,2,0,0,78
60-04,11,9,13,8,3,1,1,0,46
60-05,33,8,11,22,15,1,0,0,90
60-06,20,9,19,19,9,0,2,0,78
60-07,21,13,28,20,18,1,0,0,101
60-08,56,16,7,9,7,0,1,0,96
60-09,167,27,7,25,20,4,3,0,253
60-10,36,8,5,19,7,3,1,0,79
60-11,34,8,10,21,10,1,2,0,86
60-12,64,14,6,13,9,2,0,0,108
60-13,50,14,4,19,10,0,0,0,97
60-14,17,12,16,25,17,2,4,0,93
60-15,47,19,5,15,22,1,0,0,109
60-16,30,9,12,10,15,1,0,0,77
60-17,35,15,11,20,37,0,1,0,119
60-18,29,20,8,22,26,0,0,0,105
60-19,23,12,13,25,21,1,4,0,99
60-20,18,17,9,16,31,0,0,0,91
60-21,25,4,8,18,8,0,3,0,66
60-22,31,13,13,26,15,1,0,0,99
60-23,58,15,7,13,8,1,0,0,102
61-01,17,5,5,20,3,0,1,1,52
61-02,30,12,4,27,10,0,5,0,88
61-03,27,16,8,19,8,1,2,1,82
61-04,16,7,9,13,5,0,2,0,52
61-05,14,7,5,22,5,0,1,0,54
61-06,69,35,6,39,29,1,2,0,181
61-07,0,0,0,0,0,0,0,0,0
61-08,16,18,7,14,4,0,8,0,67
61-09,15,9,4,22,9,1,3,0,63
61-10,15,11,2,15,8,1,5,0,57
61-11,13,15,2,13,7,2,0,0,52
61-12,21,13,6,16,10,1,1,0,68
61-13,19,18,6,11,10,2,3,0,69
61-14,16,11,1,9,4,0,0,0,41
61-15,25,8,3,19,9,0,0,0,64
61-16,34,6,6,12,6,1,1,0,66
61-17,36,39,7,15,10,1,1,0,109
61-18,16,21,1,18,9,0,2,0,67
61-19,25,25,4,20,9,1,1,0,85
61-20,40,20,6,25,13,0,0,0,104
61-21,63,38,8,51,14,3,2,0,179
61-22,39,31,8,28,22,2,2,0,132
61-23,47,35,4,34,18,2,1,0,141
61-24,19,23,8,19,8,4,1,0,82
61-25,46,34,6,25,10,1,1,0,123
61-26,33,28,7,15,7,1,0,0,91
61-27,43,19,8,34,8,1,0,0,113
61-28,30,23,5,33,14,1,0,0,106
62-01,6,6,6,4,5,3,0,0,30
62-02,7,10,2,6,12,2,0,0,39
62-03,4,11,4,3,6,1,3,0,32
62-04,14,5,7,9,11,0,9,0,55
62-05,7,4,1,6,11,2,3,0,34
62-06,13,10,8,4,7,2,6,0,50
62-07,14,6,2,5,5,3,21,0,56
62-08,9,11,1,4,5,0,21,0,51
62-09,7,3,5,2,0,0,3,0,20
62-10,8,5,5,5,4,0,14,0,41
62-11,13,7,4,12,4,1,28,0,69
62-12,7,9,1,5,4,0,11,0,37
62-13,15,7,1,3,1,1,18,0,46
62-14,16,5,2,7,13,0,28,0,71
62-15,9,10,6,6,9,0,6,0,46
62-16,10,5,3,6,8,1,6,0,39
62-17,11,12,6,3,5,2,9,0,48
62-18,9,6,3,4,11,0,14,1,48
62-19,10,3,6,3,6,0,7,0,35
62-20,15,9,8,4,7,2,13,0,58
62-21,10,8,3,2,0,0,4,0,27
62-22,7,4,5,2,10,3,8,0,39
62-23,4,5,6,2,9,1,7,0,34
62-24,6,4,2,7,7,1,4,0,31
62-25,4,7,7,1,9,0,3,0,31
62-26,8,5,2,6,7,2,6,0,36
63-01,19,14,3,1,9,3,24,0,73
63-02,9,10,6,0,12,2,21,0,60
63-03,12,11,10,1,19,5,25,0,83
63-04,11,13,4,2,16,4,18,0,68
63-05,14,12,8,3,13,2,29,0,81
63-06,12,20,3,1,12,2,18,0,68
63-07,10,3,9,3,25,3,14,0,67
63-08,8,20,9,1,14,2,6,0,60
63-09,12,18,6,3,14,6,15,0,74
63-10,11,14,10,0,18,2,20,0,75
63-11,12,42,20,1,51,2,41,0,169
63-12,13,10,8,2,12,2,14,0,61
63-13,8,28,7,1,18,1,13,0,76
63-14,17,34,5,0,19,2,24,0,101
63-15,13,19,8,2,25,0,10,0,77
63-16,7,7,8,0,6,0,5,0,33
63-17,3,12,0,0,3,0,30,0,48
63-18,4,35,7,2,18,1,8,0,75
63-19,6,25,6,0,21,0,13,0,71
63-20,7,32,4,0,19,3,9,0,74
63-21,14,23,9,0,21,3,11,0,81
63-22,13,22,7,0,11,1,9,0,63
63-23,18,31,10,1,36,0,29,0,125
63-24,9,20,0,1,15,1,9,0,55
63-25,5,14,9,0,14,3,33,0,78
64-01,7,8,4,3,14,3,10,0,49
64-02,10,11,11,3,20,5,23,0,83
64-03,4,10,6,0,10,0,4,0,34
64-04,2,6,10,0,10,0,9,0,37
64-05,5,13,1,1,17,2,13,0,52
64-06,9,8,9,1,21,2,13,0,63
64-07,6,15,2,0,14,1,6,0,44
64-08,8,10,7,1,6,2,8,0,42
64-09,2,2,0,0,8,4,7,0,23
64-10,12,4,3,2,8,1,6,0,36
64-11,7,12,6,2,6,1,5,0,39
64-12,0,6,3,0,4,0,4,0,17
64-13,2,7,2,0,5,0,13,0,29
64-14,3,7,3,0,12,0,4,0,29
64-15,6,13,6,1,23,3,16,0,68
64-16,2,4,3,0,10,3,16,0,38
64-17,7,4,5,1,8,1,7,0,33
64-18,13,15,7,3,20,6,9,0,73
65-01,6,13,22,1,36,1,42,0,121
65-02,7,17,10,2,23,2,30,0,91
65-03,7,6,4,4,8,1,4,0,34
65-04,15,53,24,2,33,2,32,0,161
65-05,6,7,3,1,4,0,5,0,26
65-06,4,3,2,0,4,1,14,0,28
65-07,15,18,25,1,36,4,51,0,150
65-08,9,3,5,4,4,2,12,0,39
65-09,10,11,10,3,11,2,21,0,68
65-10,4,7,8,1,22,1,21,0,64
65-11,13,12,12,8,6,0,15,0,66
65-12,7,9,2,2,5,1,8,0,34
65-13,6,4,7,4,8,4,9,0,42
65-14,3,5,2,3,6,2,6,0,27
65-15,13,7,2,2,4,1,10,0,39
65-16,3,11,5,4,6,0,2,0,31
65-17,17,13,12,4,13,3,14,0,76
65-18,14,16,12,5,9,4,6,0,66
65-19,7,17,1,2,15,0,12,0,54
65-20,28,55,45,6,46,6,68,0,254
65-21,6,2,4,3,11,1,9,0,36
65-22,12,9,7,2,9,3,9,0,51
65-23,6,12,9,0,23,4,20,0,74
66-01,2,9,8,1,9,1,11,0,41
66-02,4,5,6,0,13,1,1,0,30
66-03,3,4,9,0,19,0,12,0,47
66-04,4,5,14,0,15,1,8,0,47
66-05,3,5,10,0,12,2,14,0,46
66-06,4,6,26,1,26,0,12,0,75
66-07,2,7,2,3,8,3,9,0,34
66-08,9,11,9,4,30,3,13,0,79
66-09,6,11,10,0,21,0,7,0,55
66-10,16,10,6,1,14,3,13,0,63
66-11,0,3,12,0,14,1,9,0,39
66-12,6,6,8,0,14,0,3,0,37
66-13,2,4,8,1,6,0,11,0,32
66-14,2,5,6,1,17,1,13,0,45
66-15,11,10,11,2,10,2,14,0,60
66-16,1,7,11,1,10,1,8,0,39
66-17,8,6,4,0,6,0,2,0,26
66-18,2,13,13,4,15,2,6,0,55
66-19,4,11,5,1,5,1,13,0,40
66-20,6,4,6,0,17,1,20,0,54
66-21,18,19,9,3,23,2,32,0,106
66-22,9,17,5,2,23,0,17,0,73
66-23,16,11,9,0,16,2,7,0,61
66-24,7,4,3,2,8,2,19,0,45
66-25,4,6,1,0,20,5,24,0,60
66-26,7,10,7,0,17,1,16,0,58
66-27,3,3,9,0,12,0,9,0,36
66-28,6,5,2,3,11,2,22,0,51
66-29,10,9,3,1,28,12,22,0,85
66-30,3,4,7,0,15,2,12,0,43
66-31,8,12,4,1,18,4,12,0,59
66-32,2,14,12,1,6,3,13,0,51
66-33,8,8,8,1,22,1,13,0,61
66-34,3,7,20,0,15,0,10,0,55
66-35,8,7,6,4,8,2,24,0,59
66-36,8,13,11,0,13,1,13,0,59
66-37,9,6,0,2,2,1,10,0,30
66-38,7,10,6,0,7,1,8,0,39
66-39,6,6,5,1,26,0,23,0,67
66-40,3,9,11,0,8,0,15,0,46
66-41,12,8,16,6,14,2,7,0,65
66-42,3,5,7,0,12,1,18,0,46
66-43,10,9,5,2,28,1,19,0,74
66-44,4,9,5,1,30,5,18,0,72
66-45,1,3,0,0,5,1,18,0,28
66-46,10,9,4,1,23,2,17,0,66
